- - - - - - - - - -
- - - - - - - x - -
- x - - - - - - - -
- - - y y y - - - -
- - - y - x - - - -
- - - y y y - - - -
- - - - - - - - - -
- - - - - - - - - -
- - - x - - - - - -
- - - - - - - - - -
